111111111111111111111111111111
1P000Y0001C010C10000100Y1Y0001
10001110C1000001010010101001E1
100Y00111111011101001010100111
1C00000000000000010010101001C1
111111111111111101000010000001
1C000C0000000000010Y0Y11111111
1000011110000Y0101000Y1C000001
10Y0000C1111000101000011111001
1C000000000000C1010000000000Y1
111111111111111111111111111111
