111111111111111111111
1P00100001C01000010E1
100010100100101001001
10001010C100001001001
100010111111001001001
1C0000000000001000001
111111111111111111111
