111111111111111111111
1P00100001C010C1000E1
100010100100100101001
10001010C100000101001
100010111111011101001
1C00000000000000010C1
111111111111111111111
