111111111111111111111111111111
1P00000001C010C100001000100001
10001110C1000001010010101001E1
100000111111011101001010100111
1C00000000000000010010101001C1
111111111111111101000010000001
1C000C000000000001000011111111
10000111100000010100001C000001
1000000C1111000101000011111001
1C000000000000C101000000000001
111111111111111111111111111111
