111111111111111111111111111111
1P00000001C010C1000010001Y0001
10001110C1000001010010101001E1
1000Y0111111011101001010100111
1C00000000000000010010101001C1
111111111111111101000010000001
1C000C000000000001000Y11111111
1000011110000Y010100001C000001
10Y0000C1111000101000011111001
1C000000000000C1010000000000Y1
111111111111111111111111111111
