111111111111111111111111111111
1P00000001C010C100001000000001
10001110C1000001010010101000E1
1000000C1111000000000011111001
1C000000000000C1010000000000Y1
111111111111111111111111111111
